****************
*P             *
*          M   *
*           ****
*           M  *
*       ***    *
*    M         *
*              *
*       G      *
****************